#######
#.....#
#.###.#
#.....#
#######
